0,1,1,1,1,1,1,1,1,1,1,1,1,1,1,1,1,1,1,1,1,1,1,1,1,1,1,1,1,0
1,1,2,2,2,2,2,2,2,2,2,2,2,2,2,2,2,2,1,2,2,2,2,2,2,2,2,2,1,1
1,2,2,2,3,4,3,4,3,4,2,2,2,2,2,2,2,2,1,2,2,2,2,5,2,5,2,2,2,1
1,2,2,2,2,2,2,2,2,2,2,2,2,2,2,2,2,2,2,2,2,2,5,2,2,2,5,2,2,1
1,1,1,1,1,1,1,2,2,2,8,2,8,2,8,2,2,2,2,2,2,2,5,2,6,2,5,2,2,1
1,2,2,2,2,2,1,2,2,2,9,2,9,2,9,2,2,2,1,2,2,2,5,2,2,2,5,2,2,1
1,2,2,2,2,2,1,2,2,2,2,2,2,2,2,2,2,2,1,2,2,2,2,5,2,5,2,2,2,1
1,2,2,2,2,2,1,2,2,2,2,2,2,2,2,2,2,2,1,2,2,2,2,2,2,2,2,2,2,1
1,2,2,2,2,2,1,1,2,2,1,1,2,2,8,2,2,2,1,1,2,2,1,1,2,2,2,2,2,1
1,2,2,2,2,2,2,2,2,2,2,1,2,2,9,2,2,2,2,2,2,2,2,1,2,2,2,2,2,1
1,2,2,5,2,5,2,2,2,2,2,1,2,2,2,2,2,2,2,2,2,2,2,1,2,2,2,2,2,1
1,2,5,2,2,2,5,2,2,2,2,1,2,2,2,2,2,2,2,2,2,2,2,1,2,2,2,2,2,1
1,2,5,2,6,2,5,2,2,2,2,1,2,2,8,2,8,2,8,2,2,2,2,1,2,2,2,2,2,1
1,2,5,2,2,2,5,2,2,2,2,2,2,2,9,2,9,2,9,2,2,2,2,1,1,1,1,1,1,1
1,2,2,5,2,5,2,2,2,2,2,2,2,2,2,2,2,2,2,2,2,2,2,2,2,2,2,2,2,1
1,2,2,2,2,2,2,2,2,2,2,1,2,2,2,2,2,2,2,2,4,3,4,3,4,3,2,2,2,1
1,1,2,2,2,2,2,2,2,2,2,1,2,2,2,2,2,2,2,2,2,2,2,2,2,2,2,2,1,1
0,1,1,1,1,1,1,1,1,1,1,1,1,1,1,1,1,1,1,1,1,1,1,1,1,1,1,1,1,0
