0,1,1,1,1,1,1,1,1,1,1,1,1,1,1,1,1,1,1,1,1,1,1,1,1,1,1,1,1,0
1,1,2,2,2,2,2,2,2,2,2,2,2,2,2,2,2,1,3,3,3,3,3,3,3,3,3,3,1,1
1,2,2,2,3,3,3,3,2,2,8,2,8,2,2,2,2,2,1,1,3,3,3,3,3,3,3,3,3,1
1,2,2,2,3,3,3,3,2,2,9,2,9,2,5,5,2,2,2,2,1,3,3,3,3,3,3,3,3,1
1,2,3,2,2,3,3,3,2,2,2,2,2,2,2,2,2,2,5,2,2,1,1,3,3,3,3,3,3,1
1,2,3,3,2,2,3,3,2,2,2,2,2,5,7,7,5,2,2,2,2,2,2,1,1,1,1,1,1,1
1,2,3,3,3,2,2,3,2,2,2,2,5,2,7,7,2,5,2,2,2,2,2,2,2,2,2,2,2,1
1,2,3,3,3,3,2,2,2,2,2,5,2,2,7,7,2,2,5,2,2,2,2,2,2,2,2,2,2,1
1,2,3,3,3,3,3,2,2,2,2,5,2,6,7,7,6,2,5,2,2,2,2,2,2,2,2,2,2,1
1,2,2,2,2,2,2,2,2,2,2,5,2,2,7,7,2,2,5,2,2,2,2,4,4,4,4,4,2,1
1,2,2,2,2,2,2,2,2,2,2,2,5,2,7,7,2,5,2,2,2,2,2,2,4,4,4,4,2,1
1,2,2,2,2,2,2,2,2,2,2,2,2,5,7,7,5,2,2,2,2,2,4,2,2,4,4,4,2,1
1,1,1,1,1,1,1,2,2,2,5,2,2,2,2,2,2,2,2,2,2,2,4,4,2,2,4,4,2,1
1,3,3,3,3,3,3,1,1,2,2,5,5,2,2,2,2,2,2,2,2,2,4,4,4,2,2,4,2,1
1,3,3,3,3,3,3,3,3,1,2,2,2,2,2,2,8,2,2,8,2,2,4,4,4,4,2,2,2,1
1,3,3,3,3,3,3,3,3,3,1,1,2,2,2,2,9,2,2,9,2,2,4,4,4,4,2,2,2,1
1,1,3,3,3,3,3,3,3,3,3,3,1,2,2,2,2,2,2,2,2,2,2,2,2,2,2,2,1,1
0,1,1,1,1,1,1,1,1,1,1,1,1,1,1,1,1,1,1,1,1,1,1,1,1,1,1,1,1,0
